NO  ./img/ls_5.xpm
SO  ./img/ls_4.xpm
WE  ./img/ls_2.xpm
EA  ./img/ls_1.xpm

F 50,20,120
C 100,70,150

1111111111111111111111111
1000000000110000000000001
1011000001110000000000001
100100000000000000000000111111111
111111111011000001110000000000001
100000000011000001110111111111111
11110111111111011100000000001
11110111111111S11101010010001
11000000110101011100000010001
10000000000000001100000010001
10000000000000001101010010001
1100000111010101111101111000111
11110111 1110101 101111010001
11111111 1110111 111111111111
           101111100011001
           101001010001001
          1001011011001001
          1000010010000011
          1110000000110001
          1000011100000001
          1111111111111111
