NO  ./img/wall_3.xpm
SO  ./img/wall_4.xpm
WE  ./img/wall_2.xpm
EA  ./img/wall_1.xpm

F 50,50,50
C 100,100,100

1111111111111111111111111
1000000000110000000000001
1011000001110000000000001
100100000000000000000000111111111
1111111110110000011100000000W0001
100000000011000001110111111111111
11110111111111011100000000001
111101111   111011101010010001
11000111110111011100000010001
10000000000000001100000010001
10000000000000001101010010001
1100000111010101111101111000111
11110111 1110101 101111010001
11111111 1111111 111111111111
